Австрия - столица: Вена
Албания - столица: Тирана
Андорра - столица: Андорра-ла-Велья
Белоруссия - столица: Минск
Бельгия - столица: Брюссель
Болгария - столица: София
Босния и Герцеговина - столица: Сараево
Ватикан - столица: Ватикан
Великобритания - столица: Лондон
Венгрия - столица: Будапешт
Германия - столица: Берлин
Греция - столица: Афины
Дания - столица: Копенгаген
Исландия - столица: Рейкьявик
Испания - столица: Мадрид
Италия - столица: Рим
Латвия - столица: Рига
Литва - столица: Вильнюс
Лихтенштейн - столица: Вадуц
Люксембург - столица: Люксембург
Македония - столица: Скопье
Мальта - столица: Валлетта
Молдавия - столица: Кишинёв
Монако - столица: Монако
Нидерланды - столица: Амстердам
Норвегия - столица: Осло
Польша - столица: Варшава
Португалия - столица: Лиссабон
Россия - столица: Москва
Румыния - столица: Бухарест
Сан-Марино - столица: Сан-Марино
Сербия - столица: Белград
Словакия - столица: Братислава
Словения - столица: Любляна
Украина - столица: Киев
Финляндия - столица: Хельсинки
Франция - столица: Париж
Хорватия - столица: Загреб
Черногория - столица: Подгорица
Чехия - столица: Прага
Швейцария - столица: Берн
Швеция - столица: Стокгольм
Эстония - столица: Таллин
Донецкая Народная Республика - столица: Донецк
Ирландия - столица: Дублин
Луганская Народная Республика - столица: Луганск
Приднестровская Молдавская Республика - столица: Тирасполь
Республика Косово - столица: Приштина
Азербайджан - столица: Баку
Армения - столица: Ереван
Афганистан - столица: Кабул
Бангладеш - столица: Дакка
Бахрейн - столица: Манама
Бруней - столица: Бандар-Сери-Бегаван
Бутан - столица: Тхимпху
Восточный Тимор - столица: Дили
Вьетнам - столица: Ханой
Государство Палестина - столица: Рамалла
Грузия - столица: Тбилиси
Израиль - столица: Иерусалим
Индонезия - столица: Джакарта
Иордания - столица: Амман
Ирак - столица: Багдад
Иран - столица: Тегеран
Йемен - столица: Сана
Казахстан - столица: Астана
Камбоджа - столица: Пномпень
Катар - столица: Доха
Кипр - столица: Никосия
Киргизия - столица: Бишкек
Китайская Республика - столица: Тайбэй
КНДР - столица: Пхеньян
КНР - столица: Пекин
Кувейт - столица: Эль-Кувейт
Лаос - столица: Вьентьян
Ливан - столица: Бейрут
Малайзия - столица: Куала-Лумпур
Мальдивы - столица: Мале
Монголия - столица: Улан-Батор
Мьянма - столица: Нейпьидо
Непал - столица: Катманду
ОАЭ - столица: Абу-Даби
Оман - столица: Маскат
Пакистан - столица: Исламабад
Республика Корея - столица: Сеул
Саудовская Аравия - столица: Эр-Рияд
Сингапур - столица: Сингапур
Сирия - столица: Дамаск
Таджикистан - столица: Душанбе
Таиланд - столица: Бангкок
Туркмения - столица: Ашхабад
Турция - столица: Анкара
Узбекистан - столица: Ташкент
Филиппины - столица: Манила
Шри-Ланка - столица: Шри-Джаяварденепура-Котте
Япония - столица: Токио
Индия - столица: Дели (Нью-Дели)
Нагорно-Карабахская Республика - столица: Степанакерт
Республика Абхазия - столица: Сухум
Республика Южная Осетия - столица: Цхинвал
Турецкая Республика Северного Кипра - столица: Никосия
Алжир - столица: Алжир
Ангола - столица: Луанда
Бенин - столица: Порто-Ново
Ботсвана - столица: Габороне
Буркина-Фасо - столица: Уагадугу
Бурунди - столица: Бужумбура
Габон - столица: Либревиль
Гамбия - столица: Банжул
Гана - столица: Аккра
Гвинея - столица: Конакри
Гвинея-Бисау - столица: Бисау
Демократическая Республика Конго - столица: Киншаса
Джибути - столица: Джибути
Египет - столица: Каир
Замбия - столица: Лусака
Зимбабве - столица: Хараре
Кабо-Верде - столица: Прая
Камерун - столица: Яунде
Кения - столица: Найроби
Коморы - столица: Морони
Кот-д’Ивуар - столица: Ямусукро
Лесото - столица: Масеру
Либерия - столица: Монровия
Маврикий - столица: Порт-Луи
Мавритания - столица: Нуакшот
Мадагаскар - столица: Антананариву
Малави - столица: Лилонгве
Мали - столица: Бамако
Марокко - столица: Рабат
Мозамбик - столица: Мапуту
Намибия - столица: Виндхук
Нигер - столица: Ниамей
Нигерия - столица: Абуджа
Республика Конго - столица: Браззавиль
Руанда - столица: Кигали
Сан-Томе и Принсипи - столица: Сан-Томе
Сахарская Арабская Демократическая Республика - столица: Тифарити
Свазиленд - столица: Мбабане
Сейшельские Острова - столица: Виктория
Сенегал - столица: Дакар
Сомали - столица: Могадишо
Сомалиленд - столица: Харгейса
Судан - столица: Хартум
Сьерра-Леоне - столица: Фритаун
Танзания - столица: Додома
Того - столица: Ломе
Тунис - столица: Тунис
Уганда - столица: Кампала
ЦАР - столица: Банги
Чад - столица: Нджамена
Экваториальная Гвинея - столица: Малабо
Эритрея - столица: Асмэра
Эфиопия - столица: Аддис-Абеба
ЮАР - столица: Претория
Южный Судан - столица: Джуба
Ливия - столица: Триполи
Антигуа и Барбуда - столица: Сент-Джонс
Аргентина - столица: Буэнос-Айрес
Багамы - столица: Нассау
Барбадос - столица: Бриджтаун
Белиз - столица: Бельмопан
Боливия - столица: Сукре
Бразилия - столица: Бразилиа
Венесуэла - столица: Каракас
Гаити - столица: Порт-о-Пренс
Гайана - столица: Джорджтаун
Гватемала - столица: Гватемала
Гондурас - столица: Тегусигальпа
Гренада - столица: Сент-Джорджес
Доминика - столица: Розо
Доминиканская Республика - столица: Санто-Доминго
Канада - столица: Оттава
Колумбия - столица: Богота
Коста-Рика - столица: Сан-Хосе
Куба - столица: Гавана
Мексика - столица: Мехико
Никарагуа - столица: Манагуа
Панама - столица: Панама
Парагвай - столица: Асунсьон
Перу - столица: Лима
Сальвадор - столица: Сан-Сальвадор
Сент-Винсент и Гренадины - столица: Кингстаун
Сент-Китс и Невис - столица: Бастер
Сент-Люсия - столица: Кастри
Суринам - столица: Парамарибо
США - столица: Вашингтон
Тринидад и Тобаго - столица: Порт-оф-Спейн
Уругвай - столица: Монтевидео
Чили - столица: Сантьяго
Эквадор - столица: Кито
Ямайка - столица: Кингстон
Австралия - столица: Канберра
Вануату - столица: Порт-Вила
Кирибати - столица: Южная Тарава (Баирики)
Маршалловы Острова - столица: Маджуро
Микронезия - столица: Паликир
Науру - столица: Официальной столицы нет
Новая Зеландия - столица: Веллингтон
Палау - столица: Нгерулмуд
Папуа — Новая Гвинея - столица: Порт-Морсби
Самоа - столица: Апиа
Соломоновы Острова - столица: Хониара
Тонга - столица: Нукуалофа
Тувалу - столица: Фунафути
Фиджи - столица: Сува